The	The
discussions	discussions
yesterday	yesterday
in	in
the	the
House	House
of	of
Lords	Lords
began	began
with	with
some	some
explanations	explanations
and	and
letters	letters
on	on
the	the
affair	affair
of	of
the	the
at	at
Milan,	Milan,
the	the
threat	threat
So	So
far	far
as	as
Lord	Lord
explanation	explanation
went,	went,
which	which
was	was
of	of
an	an
ex	ex
nature,	nature,
it	it
might	might
appear	appear
We	We
would	would
now	now
point	point
general	general
attention	attention
to	to
the	the
whole	whole
of	of
this	this
correspondence	correspondence
The	The
facts	facts
are	are
This	This
the	the
most	most
respectable	respectable
man,	man,
as	as
Lord	Lord
stated	stated
to	to
did	did
But	But
now	now
lay	lay
before	before
the	the
nation,	nation,
has	has
almost	almost
ceased	ceased
to	to
be	be
astonished	astonished
at	at
any	any
new	new
iniquity	iniquity
in	in
this	this
most	most
iniquitous	iniquitous
a	a
must	must
now	now
be	be
given	given
up	up
