OCTOBER	OCTOBER
journals	Paris
overhow	journals
on	rejoicings
the	on
birth	the
of	birth
the	of
young	the
Prince.	young
There	Prince.
is,	There
indeed,	is,
nothing	indeed,
to	nothing
be	to
found	be
in	found
the	in
Meni-	the
a	a
list	list
of	of
declarations	declarations
by	by
the	the
Duc	Duc
d'ALBUFERtA,	d'
other	sixteen
individuals,	other
authenticating	individuals,
the-fact	authenticating
and	the
tlhe	circumstances
accoucliernett,	of
together	the
of	with
the	the
has	the
been	child,
CHARLES	been
fERDINAND	called
BORDEAUX.	d'Artois,
this	de
long	Bordeaux.
of	this
names,	long
that	succession
of	of
Louis,	names,
it	that
is	of
observhble,	Louis,
has	it
been	is
omitted.	observable,
