@@232150	##	fo
French	french	jj_nn1
politics	politics	nn1
may	may	vm
be	be	vbi
subject	subject	ii21
to	to	ii22
ups	up	nn2
and	and	cc
downs	down	nn2
,	,	y
but	but	ccb
French	french	jj
production	production	nn1
is	be	vbz
going	go	vvg
in	in	ii_rp@
one	one	mc1
direction-up	direction-up	nn1	
.	.	y
In	in	ii
May	may	npm1
the	the	at
official	official	nn1_jj
index	index	vvi
for	for	if
industrial	industrial	jj
production	production	nn1
climbed	climb	vvd_vvn@
to	to	ii
an	an	at1
alltime	alltime	nnt1
high	high	jj_nn1%_rr@
of	of	io
158	158	mc
(	(	y
on	on	ii
a	a	at1
scale	scale	nn1
in	in	ii
which	which	ddq
1938	1938	mc
production	production	nn1
is	be	vbz
100	100	mc
)	)	y
.	.	y
Automobile	automobile	nn1
output	output	nn1_vvn@
in	in	ii
April	april	npm1
rose	rise	vvd
33%	33%	nnu
,	,	y
textiles	textile	nn2
11%	11%	nnu
,	,	y
chemicals	chemical	nn2
20%	20%	nnu
,	,	y
electricity	electricity	nn1
15%	15%	nnu
over	over	ii
the	the	at
same	same	da
month	month	nnt1
in	in	ii
1953	1953	mc
.	.	y
Altogether	altogether	rr
France	france	np1
's	's	ge
total	total	jj
industrial	industrial	jj
output	output	nn1
is	be	vbz
nearly	nearly	rr
8.2%	8.2%	fo
higher	high	rrr@
than	than	csn
a	a	at1
year	year	nnt1
ago	ago	ra
.	.	y
The	the	at
difficulty	difficulty	nn1
is	be	vbz
that	that	cst_dd1
higher	high	jjr
production	production	nn1
has	have	vhz
yet	yet	rr
to	to	to
reflect	reflect	vvi
itself	itself	ppx1
in	in	ii_rp@
substantially	substantially	rr
lower	low	jjr
prices	price	nn2
or	or	cc
higher	high	jjr
wages	wage	nn2
for	for	if
the	the	at
average	average	jj_nn1
Frenchman	frenchman	nn1
.	.	y
